0000000000000000000000000000000000000000000000000000000000000000
0000000000000000000000000000000000000000000000000000000000000000
0000000000000000000000000000000000000000000000000000000000000000
0000000000000000000000000000000000000000000000000000000000000000
1111111111111111111111111111111111111111111111111111111111111111
1000000000000000000000000000000110000000000000000000000000000001
1000000000000000000000000000000110000000000000000000000000000001
1000000000000000000000000000000000000000000000000000000000000001
1000000000000000000000000000000000000000000000000000000000000001
1000000000111111000000000000000000000000000000001111110000000001
1000000000000000000000000000000000000000000000000000000000000001
1000000000000000000000111100000000000011110000000000000000000001
1000000000000000000000100000000000000000010000000000000000000001
1000000000000000000000100000000000000000010000000000000000000001
1000000000000000000000100000000000000000010000000000000000000001
1000000000000000000000000000000000000000000000000000000000000001
1000011100000000000000000000000000000000000000000000000011100001
1000000100000000000000000000000000000000000000000000000010000001
1000000100000000000000000000000000000000000000000000000010000001
1000000100000001100000000000000000000000000000011000000010000001
1000000100000001100000000000000000000000000000011000000010000001
1000000100000000000000000000000000000000000000000000000010000001
1000000100000000000000000000000000000000000000000000000010000001
1000011100000000000000000000000000000000000000000000000011100001
1000000000000000000000000000000000000000000000000000000000000001
1000000000000000000000100000000000000000010000000000000000000001
1000000000000000000000100000000000000000010000000000000000000001
1000000000000000000000100000000000000000010000000000000000000001
1000000000000000000000111100000000000011110000000000000000000001
1000000000000000000000000000000000000000000000000000000000000001
1000000000111111000000000000000000000000000000001111110000000001
1000000000000000000000000000000000000000000000000000000000000001
1000000000000000000000000000000000000000000000000000000000000001
1000000000000000000000000000000110000000000000000000000000000001
1000000000000000000000000000000110000000000000000000000000000001
1111111111111111111111111111111111111111111111111111111111111111