0000000000000000000000000000000000000000000000000000000000000000
0000000000000000000000000000000000000000000000000000000000000000
0000000000000000000000000000000000000000000000000000000000000000
0000000000000000000000000000000000000000000000000000000000000000
1111111111111111111111111111111111111111111111111111111111111111
1000000000000000000000000000000000000000000000000000000000000001
1000000000000000000000000000000000000000000000000000000000000001
1000000000000000000000000000000000000000000000000000000000000001
1000000000000000000000000000000000000000000000000000000000000001
1000000000000000000000000000000000000000000000000000000000000001
1000000000000000000000000000000110000000000000000000000000000001
1000000000000000000000000000000110000000000000000000000000000001
1000000000000000000000000000000110000000000000000000000000000001
1000000000000000000000000000000110000000000000000000000000000001
1000000011111000000000000000000110000000000000000001111100000001
1000000000001000000000000000000110000000000000000001000000000001
1000000000001000000000000000000000000000000000000001000000000001
1000000000001000000000000000000000000000000000000001000000000001
1000000000001000000000000000000000000000000000000001000000000001
1000000000001000000111111000000000000001111110000001000000000001
1000000000001000000111111000000000000001111110000001000000000001
1000000000001000000000000000000000000000000000000001000000000001
1000000000001000000000000000000000000000000000000001000000000001
1000000000001000000000000000000000000000000000000001000000000001
1000000000001000000000000000000110000000000000000001000000000001
1000000011111000000000000000000110000000000000000001111100000001
1000000000000000000000000000000110000000000000000000000000000001
1000000000000000000000000000000110000000000000000000000000000001
1000000000000000000000000000000110000000000000000000000000000001
1000000000000000000000000000000110000000000000000000000000000001
1000000000000000000000000000000000000000000000000000000000000001
1000000000000000000000000000000000000000000000000000000000000001
1000000000000000000000000000000000000000000000000000000000000001
1000000000000000000000000000000000000000000000000000000000000001
1000000000000000000000000000000000000000000000000000000000000001
1111111111111111111111111111111111111111111111111111111111111111