0000000000000000000000000000000000000000000000000000000000000000
0000000000000000000000000000000000000000000000000000000000000000
0000000000000000000000000000000000000000000000000000000000000000
0000000000000000000000000000000000000000000000000000000000000000
1111111111111111111111111111111111111111111111111111111111111111
1444444444444444444444444444444444444444444444444444444444444441
1444444444444444444444444444444444444444444444444444444444444441
1444444444444444444444444444444444444444444444444444444444444441
1444444444444444444444444444444444444444444444444444444444444441
1444444444444444444444444444444444444444444444444444444444444441
1444444444444444444444444444444444444444444444444444444444444441
1444444444444444444444444444444444444444444444444444444444444441
1444444444444444444444444444444444444444444444444444444444444441
1444444444444444444444444444444444444444444444444444444444444441
1444444444444444444444444444444444444444444444444444444444444441
1444444444444444444444444444444444444444444444444444444444444441
1444444444444444444444444444444444444444444444444444444444444441
1444444444444444444444444444444444444444444444444444444444444441
1444444444444444444444444444444444444444444444444444444444444441
1444444444444444444444444444444444444444444444444444444444444441
1444444444444444444444444444444444444444444444444444444444444441
1444444444444444444444444444444444444444444444444444444444444441
1444444444444444444444444444444444444444444444444444444444444441
1444444444444444444444444444444444444444444444444444444444444441
1444444444444444444444444444444444444444444444444444444444444441
1444444444444444444444444444444444444444444444444444444444444441
1444444444444444444444444444444444444444444444444444444444444441
1444444444444444444444444444444444444444444444444444444444444441
1444444444444444444444444444444444444444444444444444444444444441
1444444444444444444444444444444444444444444444444444444444444441
1444444444444444444444444444444444444444444444444444444444444441
1444444444444444444444444444444444444444444444444444444444444441
1444444444444444444444444444444444444444444444444444444444444441
1444444444444444444444444444444444444444444444444444444444444441
1444444444444444444444444444444444444444444444444444444444444441
1111111111111111111111111111111111111111111111111111111111111111