0000000000000000000000000000000000000000000000000000000000000000
0000000000000000000000000000000000000000000000000000000000000000
0000000000000000000000000000000000000000000000000000000000000000
0000000000000000000000000000000000000000000000000000000000000000
1111111111111111111111111111111111111111111111111111111111111111
1000000000000000000000000000000000000000000000000000000000000001
1000000000000000000000000000000000000000000000000000000000000001
1001100110011001100110011001100110011001100110011001100110011001
1001100110011001100110011001100110011001100110011001100110011001
1000000000000000000000000000000000000000000000000000000000000001
1000000000000000000000000000000000000000000000000000000000000001
1001100110011001100110011001100110011001100110011001100110011001
1001100110011001100110011001100110011001100110011001100110011001
1000000000000000000000000000000000000000000000000000000000000001
1000000000000000000000000000000000000000000000000000000000000001
1001100110011001100110011001100110011001100110011001100110011001
1001100110011001100110011001100110011001100110011001100110011001
1000000000000000000000000000000000000000000000000000000000000001
1000000000000000000000000000000000000000000000000000000000000001
1001100110011001100110011001100110011001100110011001100110011001
1001100110011001100110011001100110011001100110011001100110011001
1000000000000000000000000000000000000000000000000000000000000001
1000000000000000000000000000000000000000000000000000000000000001
1001100110011001100110011001100110011001100110011001100110011001
1001100110011001100110011001100110011001100110011001100110011001
1000000000000000000000000000000000000000000000000000000000000001
1000000000000000000000000000000000000000000000000000000000000001
1001100110011001100110011001100110011001100110011001100110011001
1001100110011001100110011001100110011001100110011001100110011001
1000000000000000000000000000000000000000000000000000000000000001
1000000000000000000000000000000000000000000000000000000000000001
1001100110011001100110011001100110011001100110011001100110011001
1001100110011001100110011001100110011001100110011001100110011001
1000000000000000000000000000000000000000000000000000000000000001
1000000000000000000000000000000000000000000000000000000000000001
1111111111111111111111111111111111111111111111111111111111111111